32
32
################################
#..............................#
#..............................#
#...#########################..#
#.....................#.....#..#
#.....#.#..##.........#.....#..#
#......#...#.#.....#..#..#..#..#
#.....#.#..##......#.....#.....#
#..................#.....#.....#
#...############################
..........##........#...........
....................#...........
................................
...####.........................
................................
................................
................................
...@............................
................................
................................
........................@.......
................................
................................
................................
................................
................................
................................
................................
................................
................................
................................
................................