DDDDDDDDDDDDDDDDDDDDDDDDDDDDDDDDDDDDDDDDDDDDDDDDDDDDDDDDDDDDDDDD
DDDDDDDDDDDDDDDDDDDDDDDDDDDDDDDDDDDDDDDDDDDDDDDDDDDDDDDDDDDDDDDD
DDDDDDDDDDDDDDDDDDDDDDDDDDDDDDDDDDDDDDDDDDDDDDDDDDDDDDDDDDDDDDDD
DDDDDDDDDDDDDDDDDDDDDDDDDDDDDDDDDDDDDDDDDDDDDDDDDDDDDDDDDDDDDDDD
DDDDDDDDDDDDDDDDDDDDDDDDDDDDDDDDDDDDDDDDDDDDDDDDDDDDDDDDDDDDDDDD
DDDDDDDDDDDDDDDDDDDDDDDDDDDDDDDDDDDDDDDDDDDDDDDDDDDDDDDDDDDDDDDD
DDDDDDDDDDDDDDDDDDDDDDDDDDDDDDDDDDDDDDDDDDDDDDDDDDDDDDDDDDDDDDDD
DDDDDDDDDDDDDDDDDDDDDDDDDDDDDDDDDDDDDDDDDDDDDDDDDDDDDDDDDDDDDDDD
DDDDDDDDDDDDDDDDDDDDDDDDDDDDDDDDDDDDDDDDDDDDDDDDDDDDDDDDDDDDDDDD
DDDDDDDDDFG333333333333333333333333333333333333333333HIDDDDDDDDD
DDDDDDDDDJK999C99999999999999999999999999C99999999999LMDDDDDDDDD
DDDDDDDDD29900C00000000999000000999000000C0999000000994DDDDDDDDD
DDDDDDDDD29A99C99999999999999999999999999C9999999999A94DDDDDDDDD
DDDDDDDDD29A951111111169A95111169A9511111169A9511169A94DDDDDDDDD
DDDDDDDDD29A94DDDDDDDD29A94DDDD29A94W|YXXX29A94W|Y29A94DDDDDDDDD
DDDDDDDDD29A94DXXXDWYD29A94DWYD29A94W|Y---29A94W|Y29A94DDDDDDDDD
DDDDDDDDD29A94D---DWYD29A94DWYD29A94W|YVVV2BBB4W|Y29A94DDDDDDDDD
DDDDDDDDD29A94DVVVDWYD29A94DWYD29A94W|YEFG89A94W|Y29A94DDDDDDDDD
DDDDDDDDD29A94DDDDDWYD29A94DWYD29A94W|YEJK99A94DDD29A94DDDDDDDDD
DDDDDDDDD29A94DXXXDDDD2BBB4DDDD29A94W|YE2999A94DDD29A94DDDDDDDDD
DDDDDDDDD29A94DVVVDDFG89A97HIDD29A94W|YE2999A94DDD29A94DDDDDDDDD
DDDDDDDDD29A94DDDDDDJK99999LMDD2BBB4W|YE2999A94DDD29A94DDDDDDDDD
DDDDDDDDD29A973333338999999973389A94W|YE2999A94DDD29A94DDDDDDDDD
DDDDDDDDD2999999999C999516999C999994W|YENO99A94DDD29A94DDDDDDDDD
DDDDDDDDD2999000000C0994E2990C009994W|YERS69A94W|Y29A94DDDDDDDDD
DDDDDDDDD2999999999C999738999C999994W|YXXX29A94W|Y29A94DDDDDDDDD
DDDDDDDDD29A951111116999999951169A94W|Y---29A94W|Y29A94DDDDDDDDD
DDDDDDDDD29A94DDDDDDNO99999PQDD29A94W|YVVV29A94W|Y29A94DDDDDDDDD
DDDDDDDDD29A94DXXXXDRS69A95TUDD29A9733333389A9733389A94DDDDDDDDD
DDDDDDDDD29A94D----DDD2BBB4DDDD2999999999C9999999999994DDDDDDDDD
DDDDDDDDD29A94DVVVVDDD29A94DWYD2999000000C0999000009994DDDDDDDDD
DDDDDDDDD29A94DDDDDDDD29A94DWYD2999999999C9999999999994DDDDDDDDD
DDDDDDDDD29A94DW|YDWYD29A94DWYD29A951111111111111169A94DDDDDDDDD
DDDDDDDDD29A94DW|YDWYD29A94DWYD29A94DDDDEEEEEEDDDD2BBB4DDDDDDDDD
DDDDDDDDD29A94DW|YDWYD29A94DWYD29A94DXXXEEEEEEXXXD29A94DDDDDDDDD
DDDDDDDDD29A94DW|YDWYD29A94DWYD29A94D---EEEEEE---D29A94DDDDDDDDD
DDDDDDDDD29A94DDDDDEEE29A94DDDD2BBB4DVVVEEEEEEVVVD29A94DDDDDDDDD
DDDDDDDDD29A94DXXXXEEE29A97333389A94DDDDEEEEEEDDDD29A94DDDDDDDDD
DDDDDDDDD29A94DXXXXEEE29999C99999994DXXXEEEEEEXXXD29A94DDDDDDDDD
DDDDDDDDD29A94DVVVVEEE29990C00009994D---EEEEEE---D29A94DDDDDDDDD
DDDDDDDDD29A94DVVVVEEE29999C99999994DVVVEEEEEEVVVD29A94DDDDDDDDD
DDDDDDDDD2BBB4DDDDDEEE29A95111169A94DDDDEEEEEEDDDD29A94DDDDDDDDD
DDDDDDDDD29A973333333389A94XXXX29A94DXXXEEEEEEXXXD29A94DDDDDDDDD
DDDDDDDDD2999999999C9999A94XXXX29A94D---EEEEEE---D29A94DDDDDDDDD
DDDDDDDDD2999000000C0000994XXXX29A94DVVVEEEEEEVVVD29A94DDDDDDDDD
DDDDDDDDD2999999999C99999PQXXXX29A94DDDDEEEEEEDDDD29A94DDDDDDDDD
DDDDDDDDD29A9511111111111TUDDDD29A94DXXXEEEEEEXXXD29A94DDDDDDDDD
DDDDDDDDD2BBB4XXXXXDXXXXXDXXXXX29A94D---EEEEEE---D29A94DDDDDDDDD
DDDDDDDDD29A94-----D-----D-----29A94DVVVEEEEEEVVVD29A94DDDDDDDDD
DDDDDDDDD29A94VVVVVDVVVVVDVVVVV29A94DDDDEEEEEEDDDD29A94DDDDDDDDD
DDDDDDDDD29A973333333333333333389A973333333333333389A94DDDDDDDDD
DDDDDDDDD29A999999999999999999C9999999999999C9999999A94DDDDDDDDD
DDDDDDDDD299000000000000000000C0999000000000C0000000994DDDDDDDDD
DDDDDDDDDNO9999999999999999999C9999999999999C99999999PQDDDDDDDDD
DDDDDDDDDRS111111111111111111111111111111111111111111TUDDDDDDDDD
DDDDDDDDDDDDDDDDDDDDDDDDDDDDDDDDDDDDDDDDDDDDDDDDDDDDDDDDDDDDDDDD
DDDDDDDDDDDDDDDDDDDDDDDDDDDDDDDDDDDDDDDDDDDDDDDDDDDDDDDDDDDDDDDD
DDDDDDDDDDDDDDDDDDDDDDDDDDDDDDDDDDDDDDDDDDDDDDDDDDDDDDDDDDDDDDDD
DDDDDDDDDDDDDDDDDDDDDDDDDDDDDDDDDDDDDDDDDDDDDDDDDDDDDDDDDDDDDDDD
DDDDDDDDDDDDDDDDDDDDDDDDDDDDDDDDDDDDDDDDDDDDDDDDDDDDDDDDDDDDDDDD
DDDDDDDDDDDDDDDDDDDDDDDDDDDDDDDDDDDDDDDDDDDDDDDDDDDDDDDDDDDDDDDD
DDDDDDDDDDDDDDDDDDDDDDDDDDDDDDDDDDDDDDDDDDDDDDDDDDDDDDDDDDDDDDDD
DDDDDDDDDDDDDDDDDDDDDDDDDDDDDDDDDDDDDDDDDDDDDDDDDDDDDDDDDDDDDDDD
DDDDDDDDDDDDDDDDDDDDDDDDDDDDDDDDDDDDDDDDDDDDDDDDDDDDDDDDDDDDDDDD